100000000000000000
000000999000000000
000000999000000000
000000999000000000
000000000000000002
